1111111111111111111111
1E0000000000000C000001
1010010000100000101001
1010010000101000000011
1P0000000C00C00N000001
1111111111111111111111