1111111111111111111111
1E0000000000000C000001
1010010100100000101001
1010010010101010000011
1P0000000C00C00N000001
1111111111111111111111