111111111111111111111111
1E0000001000000C00000001
10C00C001010000010100001
1000CC0000C010000000C001
1P0000000100C00N00C0C0C1
10000000010000000000C001
111111111111111111111111