1111111111111111
1E00000C00000001
10000C0C0C000001
1000CCCCCCC00001
1P000C0C0C000001
1000000C000000N1
1111111111111111